1111111111111
100100P0000E1
1000011111C01
1P00110000001
1111111111111