1111111111111
100101P1000E1
10C0011111001
1000110000001
1111111111111